Where The Streets Have No Name - Remastered - U2
Timpani Drum Roll Kettledrum Circus Clown Tension Dramatic Cartoon Timps Timp Rolls Sound FX Sound Effects Drum Crescendo Bass Drum Sound Effects Musical Instruments and Sounds Drums-Timpani - Serious About Sound Effects
The Less I Know The Better - Tame Impala
Backup Plan - Maya Hawke
Time After Time - Cyndi Lauper
Take on Me - a-ha
Maniac - Michael Sembello
Running Away - Thee Sacred Souls
Prism - Say She She
Passion - RAC
Electric U - Kid Bloom
Xanadu - Olivia Newton-John
Gimme! Gimme! Gimme! (A Man After Midnight) - ABBA
Emotions - Mariah Carey
Morning Train (Nine to Five) - Edit - Sheena Easton
Legends Never Die - with Shania Twain - Orville Peck
Malibu - Trixie Mattel
Kitty Girl - RuPaul
Love at First Sight - Kylie Minogue
Espresso - Sabrina Carpenter
A Little Respect - Erasure
Smalltown Boy - Bronski Beat
HOT TO GO! - Chappell Roan
Last Night A D.J. Saved My Life - Indeep
Don't Stop Me Now - Remastered 2011 - Queen
Heroes - 2017 Remaster - David Bowie
I'm Still Standing - Elton John
Love Is A Battlefield - Pat Benatar
Signed, Sealed, Delivered (I'm Yours) - Stevie Wonder
out 4 a breather - dad sports
City Lights - Hall Johnson
Toronto - Jamws
One Wish - Hiroshima
Leave The Door Open - Bruno Mars
LEFT RIGHT - XG
After the Play Is Over - 샤프
Sunshine - Lee Sugar
Intergalactic Janet - Ley Soul
Lauren (I Can't Stay Forever) - Oden & Fatzo
How You Feel (Ft. Leven Kali) - ANOTR
Home - Caribou
Back On 74 - Jungle
Cinderella - Remi Wolf
Music Sounds Better With You - Radio Edit - Stardust
MILLION DOLLAR BABY - Tommy Richman
I AM - IVE
Forever Young - BLACKPINK
Standing Next to You - Jung Kook
MANIAC - VIVIZ
Got Caught in Amsterdam - Arc De Soleil
Home Soon - DOPE LEMON
This Must Be the Place (Naive Melody) - 2005 Remaster - Talking Heads
Romance - CRSB
I Think You're Beautiful - Kolohe Kai
Slow Down - Skip Marley
Talkin' To Me (Edit) - Amerie
From The Start - Laufey
Home Again - Menahan Street Band
Morning Broadway - Keith Mansfield
More Spell On You - Eddie Johns
Butter - BTS
Diamond Girl - Seals and Crofts
Show Me The Way - Peter Frampton
Face to Face - Daft Punk
Looking for a Place - The Spyres
There's a New Day Coming - Menahan Street Band
Shameful Game - Pale Jay
Whatcha Gonna Do - The Valdons
Seems Like - Thee Sinseers
I Don’t Mind - Joey Quinones
Louie, Louie - Los Yesterdays
Come Around and Love Me - Jalen Ngonda
It's Our Love - Thee Sacred Souls
Lady Love - Thee Sacred Souls
What's Happening Brother - Marvin Gaye
La Vida Es Fría - Jason Joshua
Easier Said Than Done - Thee Sacred Souls
Open My Door - Alice Phoebe Lou
Parachute - Thee Lakesiders
What's His Name - Joey Quinones
I Can See Clearly Now - Johnny Nash
Your Love - Saskwatch
Promises, Promises - US Single Version - Naked Eyes
Holiday - Madonna
Conga! - Miami Sound Machine
I'm So Excited - The Pointer Sisters
Shake Your Groove Thing - Peaches & Herb
Disco Inferno - The Trammps
You Make Me Feel Like Dancing - Remastered - Leo Sayer
Lovely Day - Bill Withers
50 Ways to Leave Your Lover - Paul Simon
You Sexy Thing - Hot Chocolate
I Can't Go for That (No Can Do) - Daryl Hall & John Oates
Bennie And The Jets - Remastered 2014 - Elton John
Do It Again - Steely Dan
Stuck In The Middle With You - Stealers Wheel
Spooky - Dusty Springfield
Ventura Highway - America
